Day,Hour,Requirement,Working Employees,Count of Employees Working,Extra
0,0,3,"[0, 1, 2]",3,0
0,1,3,"[0, 1, 2]",3,0
0,2,2,"[0, 1, 2, 7]",4,2
0,3,4,"[0, 2, 5, 7]",4,0
0,4,3,"[0, 1, 5, 7]",4,1
0,5,3,"[1, 2, 5]",3,0
0,6,5,"[0, 1, 2, 5, 7]",5,0
0,7,5,"[0, 1, 2, 5, 7]",5,0
0,8,2,"[0, 1, 2, 7]",4,2
0,9,6,"[5, 7, 10, 14, 18, 20]",6,0
0,10,6,"[5, 7, 10, 14, 18, 20, 28]",7,1
0,11,3,"[5, 10, 14, 18, 20, 28]",6,3
0,12,3,"[10, 14, 18, 28]",4,1
0,13,2,"[18, 20, 28]",3,1
0,14,2,"[10, 14, 20]",3,1
0,15,3,"[6, 9, 10, 14, 18, 20, 26, 28]",8,5
0,16,5,"[3, 6, 9, 10, 14, 18, 20, 23, 24, 26, 28]",11,6
0,17,6,"[3, 6, 9, 10, 14, 18, 20, 23, 24, 26, 28]",11,5
0,18,7,"[3, 6, 9, 23, 24, 26, 28]",7,0
0,19,3,"[3, 9, 26]",3,0
0,20,2,"[6, 23, 24]",3,1
0,21,5,"[3, 6, 9, 23, 24, 26]",6,1
0,22,3,"[3, 6, 9, 23, 24, 26]",6,3
0,23,4,"[3, 6, 9, 23, 24, 26]",6,2
1,0,2,"[3, 4, 5, 15, 23, 24]",6,4
1,1,7,"[1, 2, 4, 5, 11, 15, 25]",7,0
1,2,6,"[1, 2, 4, 5, 11, 15, 25]",7,1
1,3,4,"[1, 2, 11, 15, 25]",5,1
1,4,2,"[4, 5, 11]",3,1
1,5,7,"[1, 2, 4, 5, 11, 15, 25]",7,0
1,6,6,"[1, 2, 4, 5, 15, 16, 19, 25]",8,2
1,7,6,"[1, 2, 4, 5, 11, 15, 16, 19, 25]",9,3
1,8,2,"[1, 2, 4, 5, 11, 15, 16, 19, 25]",9,7
1,9,7,"[1, 2, 8, 11, 16, 18, 19, 20, 25]",9,2
1,10,6,"[8, 13, 16, 18, 19, 20, 28, 29]",8,2
1,11,2,"[8, 13, 18, 20, 28, 29]",6,4
1,12,4,"[8, 13, 16, 19, 20, 28, 29]",7,3
1,13,3,"[10, 12, 13, 14, 16, 18, 19, 24, 26, 28]",10,7
1,14,7,"[7, 8, 10, 12, 14, 16, 18, 19, 20, 24, 26, 29]",12,5
1,15,5,"[0, 3, 7, 8, 9, 10, 12, 13, 14, 17, 18, 20, 22, 23, 24, 26, 28, 29]",18,13
1,16,5,"[0, 3, 7, 8, 9, 10, 13, 14, 17, 18, 20, 22, 23, 24, 26, 28, 29]",17,12
1,17,5,"[0, 3, 7, 8, 9, 10, 12, 13, 14, 17, 18, 20, 22, 23, 26, 28, 29]",17,12
1,18,4,"[0, 3, 7, 12, 13, 17, 24, 28, 29]",9,5
1,19,7,"[0, 9, 10, 12, 14, 17, 22, 23, 24, 26]",10,3
1,20,5,"[3, 7, 9, 10, 12, 14, 22, 23, 24, 26]",10,5
1,21,3,"[0, 3, 7, 9, 10, 12, 14, 17, 22, 23, 24, 26]",12,9
1,22,5,"[0, 3, 7, 9, 17, 22, 23]",7,2
1,23,4,"[0, 3, 9, 17, 22, 23]",6,2
2,0,6,"[1, 4, 5, 6, 15, 27]",6,0
2,1,5,"[1, 4, 5, 6, 15, 27]",6,1
2,2,5,"[1, 4, 5, 6, 15, 27]",6,1
2,3,6,"[1, 4, 5, 6, 15, 27]",6,0
2,4,3,"[4, 5, 6, 27]",4,1
2,5,2,"[1, 15]",2,0
2,6,4,"[1, 4, 5, 6, 11, 15, 20, 21, 25, 27, 28]",11,7
2,7,6,"[1, 4, 5, 6, 11, 15, 20, 21, 25, 27, 28]",11,5
2,8,6,"[1, 4, 5, 6, 11, 15, 18, 20, 21, 25, 27, 28]",12,6
2,9,7,"[2, 11, 14, 16, 18, 20, 21, 25, 26, 29]",10,3
2,10,2,"[2, 11, 14, 16, 18, 20, 25, 26, 28, 29]",10,8
2,11,6,"[2, 9, 14, 16, 21, 26, 28, 29]",8,2
2,12,5,"[0, 2, 9, 11, 12, 14, 16, 18, 20, 21, 25, 26, 28]",13,8
2,13,3,"[0, 9, 11, 12, 14, 16, 18, 20, 21, 25, 26, 28, 29]",13,10
2,14,5,"[0, 2, 9, 11, 12, 18, 20, 21, 23, 25, 28, 29]",12,7
2,15,5,"[0, 2, 3, 7, 8, 10, 12, 14, 16, 17, 18, 19, 23, 26, 29]",15,10
2,16,7,"[0, 2, 3, 7, 8, 9, 10, 14, 16, 17, 18, 19, 23, 26, 29]",15,8
2,17,4,"[2, 3, 7, 8, 9, 10, 12, 14, 16, 17, 19, 26, 29]",13,9
2,18,4,"[0, 3, 7, 8, 9, 10, 12, 17, 19, 23]",10,6
2,19,3,"[0, 7, 8, 9, 12, 23]",6,3
2,20,2,"[0, 3, 10, 12, 17, 19, 23]",7,5
2,21,3,"[3, 7, 8, 10, 17, 19, 23]",7,4
2,22,5,"[3, 7, 8, 10, 17, 19, 23]",7,2
2,23,6,"[3, 7, 8, 10, 17, 19]",6,0
3,0,2,"[13, 22, 24]",3,1
3,1,3,"[5, 6, 13, 22, 24, 27]",6,3
3,2,4,"[5, 6, 13, 22, 24, 27]",6,2
3,3,4,"[5, 6, 22, 24, 27]",5,1
3,4,6,"[5, 6, 13, 22, 24, 27]",6,0
3,5,4,"[5, 6, 13, 27]",4,0
3,6,7,"[1, 4, 13, 18, 22, 24, 25, 29]",8,1
3,7,4,"[1, 4, 5, 6, 13, 18, 22, 24, 25, 27, 29]",11,7
3,8,5,"[1, 4, 5, 6, 13, 18, 22, 24, 25, 27, 29]",11,6
3,9,2,"[1, 4, 5, 6, 18, 25, 27]",7,5
3,10,2,"[4, 25, 29]",3,1
3,11,6,"[1, 2, 11, 18, 21, 29]",6,0
3,12,2,"[1, 2, 4, 7, 11, 18, 21, 25, 29]",9,7
3,13,2,"[0, 1, 2, 4, 7, 9, 10, 11, 15, 18, 19, 21, 23, 25, 29]",15,13
3,14,3,"[0, 1, 2, 4, 7, 9, 10, 11, 14, 15, 18, 19, 21, 23, 25, 26, 29]",17,14
3,15,4,"[0, 2, 3, 7, 9, 10, 11, 14, 15, 16, 17, 19, 20, 21, 23, 26]",16,12
3,16,4,"[0, 3, 7, 9, 10, 14, 15, 16, 17, 20, 23, 26]",12,8
3,17,6,"[0, 2, 3, 10, 11, 14, 15, 16, 17, 19, 20, 21, 23]",13,7
3,18,6,"[2, 7, 9, 11, 14, 16, 17, 19, 20, 21, 26]",11,5
3,19,6,"[0, 2, 3, 7, 9, 10, 11, 15, 16, 17, 19, 20, 21, 23, 26]",15,9
3,20,7,"[0, 3, 7, 9, 10, 14, 15, 19, 23, 26]",10,3
3,21,7,"[0, 3, 9, 10, 14, 15, 16, 17, 19, 20, 23, 26]",12,5
3,22,5,"[3, 14, 16, 17, 20, 26]",6,1
3,23,3,"[3, 16, 17, 20]",4,1
4,0,7,"[5, 6, 8, 12, 24, 27, 28]",7,0
4,1,6,"[5, 6, 8, 12, 24, 27, 28]",7,1
4,2,6,"[5, 6, 8, 12, 24, 27, 28]",7,1
4,3,2,"[5, 6, 12, 27, 28]",5,3
4,4,2,"[8, 24, 27]",3,1
4,5,6,"[5, 6, 8, 12, 24, 28]",6,0
4,6,2,"[5, 6, 8, 12, 22, 24, 27, 28]",8,6
4,7,4,"[2, 5, 6, 8, 12, 22, 24, 27, 28]",9,5
4,8,5,"[2, 5, 6, 8, 12, 22, 24, 27, 28]",9,4
4,9,3,"[2, 9, 10, 22, 23, 25]",6,3
4,10,2,"[2, 9, 10, 19, 21, 22, 23, 25]",8,6
4,11,4,"[7, 9, 10, 17, 19, 20, 21, 23, 25]",9,5
4,12,4,"[2, 7, 10, 17, 19, 20, 21, 22, 23, 25]",10,6
4,13,2,"[2, 7, 9, 14, 17, 19, 20, 22, 23]",9,7
4,14,6,"[2, 7, 9, 10, 14, 17, 19, 20, 21, 22, 25]",11,5
4,15,7,"[0, 1, 2, 3, 7, 9, 10, 11, 13, 14, 15, 17, 18, 20, 21, 23, 25, 26, 29]",19,12
4,16,4,"[0, 1, 3, 9, 10, 11, 13, 14, 15, 18, 19, 21, 23, 25, 26, 29]",16,12
4,17,6,"[0, 1, 3, 7, 9, 10, 11, 13, 15, 17, 18, 19, 20, 21, 23, 25, 26, 29]",18,12
4,18,7,"[1, 3, 7, 11, 13, 14, 15, 17, 18, 19, 20, 21, 26, 29]",14,7
4,19,4,"[0, 1, 7, 13, 14, 17, 18, 20, 26]",9,5
4,20,2,"[0, 3, 11, 14, 15, 29]",6,4
4,21,2,"[0, 1, 3, 11, 13, 14, 15, 18, 26, 29]",10,8
4,22,4,"[0, 1, 3, 11, 13, 15, 18, 26, 29]",9,5
4,23,6,"[0, 1, 3, 11, 13, 15, 18, 26, 29]",9,3
5,0,4,"[4, 8, 16, 24, 27, 28]",6,2
5,1,6,"[4, 8, 16, 24, 27, 28]",6,0
5,2,5,"[4, 8, 16, 24, 27, 28]",6,1
5,3,5,"[8, 16, 24, 27, 28]",5,0
5,4,3,"[4, 8, 27, 28]",4,1
5,5,2,"[4, 16, 24]",3,1
5,6,6,"[4, 8, 16, 19, 23, 24, 27, 28]",8,2
5,7,5,"[4, 8, 16, 19, 23, 24, 27, 28]",8,3
5,8,7,"[4, 7, 8, 10, 12, 16, 19, 23, 24, 27, 28]",11,4
5,9,6,"[5, 7, 9, 10, 12, 17, 19, 23]",8,2
5,10,5,"[2, 5, 7, 9, 10, 12, 14, 17, 19, 23]",10,5
5,11,2,"[2, 5, 7, 9, 10, 14, 17]",7,5
5,12,6,"[2, 5, 7, 9, 10, 12, 14, 17, 19, 23]",10,4
5,13,3,"[12, 14, 17, 19, 21, 23]",6,3
5,14,4,"[0, 2, 5, 7, 9, 10, 12, 19, 21, 23, 29]",11,7
5,15,3,"[0, 2, 3, 5, 6, 7, 9, 10, 12, 13, 14, 15, 17, 18, 21, 22, 25, 29]",18,15
5,16,3,"[0, 2, 3, 5, 6, 7, 9, 10, 12, 13, 14, 15, 17, 18, 21, 22, 25, 29]",18,15
5,17,5,"[0, 2, 3, 5, 6, 9, 13, 14, 15, 17, 18, 22, 25, 29]",14,9
5,18,2,"[0, 2, 3, 6, 13, 14, 18, 21, 22]",9,7
5,19,2,"[3, 6, 15, 18, 21, 25, 29]",7,5
5,20,5,"[0, 13, 15, 21, 22, 25, 29]",7,2
5,21,3,"[0, 3, 6, 13, 15, 18, 21, 22, 25, 29]",10,7
5,22,3,"[0, 3, 6, 13, 15, 18, 22, 25, 29]",9,6
5,23,7,"[3, 6, 13, 15, 18, 22, 25]",7,0
6,0,6,"[1, 11, 20, 24, 27, 28]",6,0
6,1,7,"[1, 11, 20, 24, 26, 27, 28]",7,0
6,2,7,"[1, 11, 20, 24, 26, 27, 28]",7,0
6,3,7,"[1, 11, 20, 24, 26, 27, 28]",7,0
6,4,3,"[20, 24, 26, 27, 28]",5,2
6,5,2,"[1, 11]",2,0
6,6,5,"[1, 7, 10, 11, 14, 20, 24, 26, 27, 28]",10,5
6,7,6,"[1, 7, 10, 11, 14, 16, 20, 24, 26, 27, 28]",11,5
6,8,2,"[1, 7, 9, 10, 11, 14, 16, 20, 24, 26, 27, 28]",12,10
6,9,6,"[5, 7, 9, 10, 12, 14, 16, 21, 23, 26]",10,4
6,10,5,"[2, 5, 7, 9, 10, 12, 14, 16, 17, 21, 23]",11,6
6,11,7,"[0, 2, 5, 9, 12, 17, 21, 23]",8,1
6,12,5,"[0, 2, 5, 7, 9, 10, 12, 14, 16, 17, 21, 23]",12,7
6,13,3,"[0, 2, 3, 5, 7, 10, 12, 14, 16, 17, 21, 23]",12,9
6,14,3,"[0, 3, 7, 9, 10, 14, 16, 17]",8,5
6,15,5,"[0, 2, 3, 4, 5, 6, 8, 9, 12, 15, 16, 18, 21, 22, 23, 25]",16,11
6,16,6,"[2, 3, 4, 5, 6, 8, 9, 12, 15, 17, 18, 21, 22, 23, 25]",15,9
6,17,5,"[0, 2, 3, 4, 5, 6, 8, 12, 15, 17, 18, 21, 22, 23, 25]",15,10
6,18,7,"[0, 2, 6, 8, 15, 17, 18, 22]",8,1
6,19,2,"[0, 3, 4, 8, 22, 25]",6,4
6,20,2,"[3, 4, 6, 15, 18, 25]",6,4
6,21,5,"[3, 4, 6, 8, 15, 18, 22, 25]",8,3
6,22,2,"[4, 6, 8, 15, 18, 22, 25]",7,5
6,23,7,"[4, 6, 8, 15, 18, 22, 25]",7,0
7,0,3,"[1, 11, 19]",3,0
7,1,3,"[1, 11, 19]",3,0
7,2,3,"[1, 10, 11, 14, 19, 29]",6,3
7,3,6,"[1, 10, 11, 14, 19, 29]",6,0
7,4,4,"[1, 10, 14, 19, 29]",5,1
7,5,4,"[10, 11, 14, 29]",4,0
7,6,3,"[1, 2, 10, 11, 14, 19, 29]",7,4
7,7,3,"[1, 2, 11, 19, 26]",5,2
7,8,2,"[1, 2, 7, 10, 11, 14, 19, 26, 28, 29]",10,8
7,9,5,"[0, 2, 7, 10, 12, 14, 17, 24, 26, 28, 29]",11,6
7,10,7,"[0, 7, 9, 10, 12, 14, 17, 23, 24, 27, 28, 29]",12,5
7,11,7,"[0, 2, 7, 9, 12, 17, 23, 24, 26, 27]",10,3
7,12,3,"[0, 2, 7, 9, 17, 23, 24, 25, 26, 27, 28]",11,8
7,13,4,"[0, 2, 12, 21, 24, 25, 26, 27, 28]",9,5
7,14,3,"[2, 5, 7, 8, 9, 12, 17, 21, 23, 25, 26, 27, 28]",13,10
7,15,2,"[0, 4, 5, 6, 7, 8, 9, 12, 13, 17, 20, 21, 23, 24, 25, 26, 28]",17,15
7,16,2,"[0, 4, 5, 6, 7, 8, 9, 12, 13, 17, 20, 21, 23, 24, 25, 27, 28]",17,15
7,17,6,"[0, 4, 6, 8, 9, 12, 13, 17, 20, 23, 24, 27]",12,6
7,18,6,"[4, 5, 6, 9, 20, 21, 23, 25, 27]",9,3
7,19,2,"[4, 5, 6, 8, 13, 21, 25]",7,5
7,20,5,"[5, 8, 13, 20, 21, 25]",6,1
7,21,7,"[4, 5, 6, 8, 13, 20, 21]",7,0
7,22,6,"[4, 5, 6, 8, 13, 20]",6,0
7,23,4,"[4, 6, 13, 20]",4,0
8,0,6,"[1, 3, 11, 15, 16, 19, 22]",7,1
8,1,6,"[1, 3, 11, 15, 16, 19, 22]",7,1
8,2,4,"[1, 3, 11, 15, 16, 19, 22]",7,3
8,3,4,"[1, 3, 15, 16]",4,0
8,4,7,"[1, 3, 11, 15, 16, 19, 22]",7,0
8,5,3,"[11, 19, 22]",3,0
8,6,7,"[0, 1, 3, 9, 10, 11, 15, 16, 19, 22, 27]",11,4
8,7,2,"[0, 1, 3, 9, 10, 11, 15, 16, 19, 22, 27]",11,9
8,8,7,"[0, 1, 2, 3, 9, 10, 11, 15, 16, 19, 22, 24, 27, 29]",14,7
8,9,4,"[0, 2, 18, 24, 25, 27, 28, 29]",8,4
8,10,7,"[2, 5, 9, 10, 18, 24, 25, 28, 29]",9,2
8,11,7,"[0, 2, 5, 9, 10, 13, 18, 23, 24, 25, 27, 28, 29]",13,6
8,12,6,"[0, 5, 9, 10, 13, 18, 23, 24, 25, 27, 28]",11,5
8,13,6,"[0, 2, 5, 9, 10, 13, 18, 21, 23, 25, 27, 28, 29]",13,7
8,14,5,"[0, 2, 5, 9, 10, 12, 13, 20, 21, 23, 24, 27, 29]",13,8
8,15,2,"[2, 4, 6, 8, 12, 13, 14, 18, 20, 21, 24, 25, 26, 28, 29]",15,13
8,16,2,"[2, 4, 5, 6, 8, 12, 14, 18, 20, 21, 23, 24, 25, 26, 28, 29]",16,14
8,17,5,"[4, 5, 6, 8, 12, 13, 14, 18, 20, 21, 23, 25, 26, 28]",14,9
8,18,2,"[4, 5, 12, 13, 23, 26]",6,4
8,19,3,"[6, 8, 13, 14, 20, 21, 23, 26]",8,5
8,20,4,"[4, 6, 8, 12, 14, 20, 21]",7,3
8,21,5,"[4, 6, 8, 12, 14, 20, 21, 26]",8,3
8,22,5,"[4, 6, 8, 12, 14, 20, 26]",7,2
8,23,4,"[4, 6, 8, 14, 26]",5,1
9,0,5,"[1, 3, 15, 17, 19]",5,0
9,1,6,"[1, 3, 11, 15, 17, 19, 22]",7,1
9,2,6,"[1, 3, 11, 15, 17, 19, 22]",7,1
9,3,6,"[1, 3, 11, 15, 17, 19, 22]",7,1
9,4,2,"[11, 22]",2,0
9,5,7,"[1, 3, 11, 15, 17, 19, 22]",7,0
9,6,7,"[1, 3, 5, 10, 15, 17, 19]",7,0
9,7,5,"[1, 3, 5, 10, 11, 13, 15, 17, 19, 22, 23, 25]",12,7
9,8,4,"[1, 3, 5, 10, 11, 13, 15, 17, 18, 19, 22, 23, 25, 29]",14,10
9,9,7,"[5, 10, 11, 13, 18, 22, 23, 25, 29]",9,2
9,10,2,"[5, 10, 13, 18, 23, 29]",6,4
9,11,5,"[0, 13, 18, 23, 25, 26, 29]",7,2
9,12,3,"[0, 5, 10, 25, 26]",5,2
9,13,5,"[0, 5, 8, 10, 13, 18, 23, 25, 26, 29]",10,5
9,14,6,"[5, 6, 8, 10, 13, 18, 23, 25, 29]",9,3
9,15,3,"[0, 2, 4, 6, 8, 9, 12, 13, 14, 16, 18, 20, 23, 24, 25, 26, 27, 28, 29]",19,16
9,16,3,"[0, 2, 4, 6, 8, 9, 12, 14, 16, 18, 20, 24, 26, 27, 28, 29]",16,13
9,17,2,"[0, 2, 4, 6, 9, 12, 14, 16, 20, 24, 26, 27, 28]",13,11
9,18,2,"[0, 4, 8, 9, 12, 14, 16, 20, 24, 26, 27, 28]",12,10
9,19,4,"[0, 2, 6, 8, 9, 14, 16, 20, 26, 27, 28]",11,7
9,20,6,"[2, 4, 6, 8, 12, 24]",6,0
9,21,6,"[2, 4, 6, 8, 9, 12, 14, 16, 20, 24, 27, 28]",12,6
9,22,7,"[2, 4, 6, 9, 12, 14, 16, 20, 24, 27, 28]",11,4
9,23,5,"[2, 4, 9, 12, 14, 16, 20, 24, 27, 28]",10,5
10,0,7,"[1, 7, 11, 15, 17, 21, 22]",7,0
10,1,3,"[1, 7, 11, 15, 17, 21, 22]",7,4
10,2,2,"[1, 7, 11, 15, 17, 21, 22]",7,5
10,3,5,"[7, 11, 15, 17, 22]",5,0
10,4,5,"[1, 7, 13, 21, 22]",5,0
10,5,5,"[1, 11, 13, 15, 17, 21]",6,1
10,6,7,"[1, 7, 11, 13, 15, 17, 21, 22, 23]",9,2
10,7,5,"[1, 7, 11, 15, 17, 19, 21, 22, 23, 26]",10,5
10,8,6,"[1, 7, 11, 13, 15, 17, 19, 21, 22, 23, 26]",11,5
10,9,5,"[10, 13, 19, 26, 29]",5,0
10,10,5,"[3, 8, 10, 13, 19, 23, 26, 29]",8,3
10,11,2,"[3, 4, 8, 10, 12, 13, 19, 23, 26, 29]",10,8
10,12,6,"[3, 4, 8, 10, 12, 13, 23, 29]",8,2
10,13,4,"[3, 4, 8, 10, 12, 19, 23, 26]",8,4
10,14,3,"[0, 2, 3, 4, 5, 12, 14, 18, 19, 20, 23, 26, 28, 29]",14,11
10,15,7,"[0, 2, 4, 5, 8, 10, 12, 14, 16, 18, 19, 20, 24, 26, 27, 28, 29]",17,10
10,16,6,"[0, 2, 3, 5, 8, 10, 14, 16, 18, 20, 24, 27, 28, 29]",14,8
10,17,2,"[2, 3, 4, 5, 8, 10, 12, 16, 18, 20, 24, 27, 28, 29]",14,12
10,18,5,"[0, 3, 4, 5, 8, 12, 14, 16, 20, 27]",10,5
10,19,5,"[0, 2, 4, 12, 14, 18, 24, 27, 28]",9,4
10,20,6,"[0, 2, 5, 14, 16, 18, 20, 24, 28]",9,3
10,21,4,"[0, 2, 5, 14, 16, 18, 20, 24, 27, 28]",10,6
10,22,6,"[0, 2, 5, 14, 16, 18, 20, 24, 27, 28]",10,4
10,23,2,"[16, 24, 27]",3,1
11,0,7,"[1, 7, 9, 13, 17, 21, 25]",7,0
11,1,5,"[1, 7, 9, 13, 17, 21, 25]",7,2
11,2,2,"[1, 7, 9, 13, 17, 21, 25]",7,5
11,3,3,"[9, 17, 25]",3,0
11,4,7,"[1, 7, 9, 13, 17, 21, 25]",7,0
11,5,3,"[1, 7, 13, 21]",4,1
11,6,4,"[1, 7, 8, 9, 13, 17, 21, 23, 25, 26]",10,6
11,7,7,"[1, 3, 4, 7, 8, 9, 12, 13, 15, 17, 21, 23, 25, 26]",14,7
11,8,5,"[1, 3, 4, 7, 8, 9, 12, 13, 15, 17, 21, 23, 25, 26]",14,9
11,9,2,"[3, 4, 8, 12, 15, 23, 26]",7,5
11,10,7,"[3, 8, 12, 15, 19, 20, 23, 26]",8,1
11,11,2,"[4, 6, 12, 15, 19, 20]",6,4
11,12,3,"[3, 4, 6, 8, 19, 20, 23, 26]",8,5
11,13,3,"[3, 4, 6, 8, 11, 12, 15, 19, 20, 22, 23, 26, 27, 29]",14,11
11,14,2,"[3, 4, 8, 11, 12, 15, 22, 23, 26, 27, 29]",11,9
11,15,2,"[0, 2, 3, 4, 5, 6, 11, 12, 15, 16, 18, 19, 20, 22, 24, 27, 28, 29]",18,16
11,16,2,"[0, 2, 5, 6, 11, 16, 18, 19, 20, 22, 24, 27, 28, 29]",14,12
11,17,5,"[0, 2, 5, 6, 16, 18, 19, 20, 24, 28]",10,5
11,18,4,"[6, 11, 19, 20, 22, 27, 29]",7,3
11,19,6,"[0, 2, 5, 6, 11, 16, 18, 22, 24, 27, 28, 29]",12,6
11,20,7,"[0, 2, 5, 11, 16, 18, 22, 24, 27, 28, 29]",11,4
11,21,7,"[0, 2, 5, 11, 16, 18, 22, 24, 27, 28, 29]",11,4
11,22,5,"[0, 2, 5, 16, 18, 24, 28]",7,2
11,23,6,"[0, 2, 5, 16, 18, 24, 28]",7,1
12,0,3,"[7, 9, 10, 13, 17]",5,2
12,1,3,"[7, 9, 10, 13, 17]",5,2
12,2,6,"[7, 9, 10, 13, 17, 23, 25]",7,1
12,3,7,"[7, 9, 10, 13, 17, 23, 25]",7,0
12,4,3,"[17, 23, 25]",3,0
12,5,3,"[7, 9, 10, 13, 23]",5,2
12,6,3,"[7, 8, 9, 10, 13, 17, 25, 26]",8,5
12,7,5,"[7, 8, 9, 10, 13, 14, 17, 23, 25, 26]",10,5
12,8,2,"[7, 8, 9, 10, 13, 14, 15, 17, 20, 23, 25, 26]",12,10
12,9,5,"[8, 11, 12, 14, 15, 20, 21, 23, 25, 26]",10,5
12,10,7,"[6, 11, 12, 15, 20, 21, 23, 25, 26, 29]",10,3
12,11,3,"[6, 8, 11, 12, 14, 15, 21, 24, 29]",9,6
12,12,3,"[1, 6, 8, 11, 12, 14, 20, 24, 26, 29]",10,7
12,13,5,"[1, 3, 5, 6, 8, 11, 14, 15, 20, 21, 24, 26, 29]",13,8
12,14,2,"[1, 3, 5, 6, 8, 12, 14, 15, 20, 21, 22, 24, 26, 28, 29]",15,13
12,15,7,"[1, 3, 5, 11, 12, 14, 15, 16, 18, 20, 21, 22, 27, 28]",14,7
12,16,5,"[1, 3, 5, 6, 11, 12, 15, 16, 18, 20, 21, 22, 24, 27, 28, 29]",16,11
12,17,3,"[5, 6, 11, 12, 16, 18, 21, 22, 24, 27, 29]",11,8
12,18,4,"[1, 3, 6, 16, 18, 22, 24, 27, 28, 29]",10,6
12,19,4,"[1, 3, 5, 16, 24, 27, 28]",7,3
12,20,4,"[1, 3, 5, 18, 22, 28]",6,2
12,21,3,"[3, 5, 16, 18, 22, 27, 28]",7,4
12,22,5,"[16, 18, 22, 27, 28]",5,0
12,23,3,"[16, 18, 27]",3,0
13,0,6,"[0, 2, 4, 7, 13, 23]",6,0
13,1,7,"[0, 2, 4, 7, 10, 13, 17, 23]",8,1
13,2,5,"[0, 2, 4, 7, 10, 13, 17, 23]",8,3
13,3,5,"[0, 4, 10, 17, 23]",5,0
13,4,7,"[0, 2, 7, 10, 13, 17, 23]",7,0
13,5,6,"[2, 4, 7, 10, 13, 17]",6,0
13,6,4,"[0, 2, 4, 7, 13, 23, 29]",7,3
13,7,4,"[0, 2, 4, 7, 10, 13, 14, 15, 17, 23, 24, 26, 29]",13,9
13,8,2,"[0, 2, 4, 7, 10, 13, 14, 15, 17, 19, 21, 23, 24, 26, 29]",15,13
13,9,7,"[10, 11, 14, 15, 17, 19, 20, 21, 24, 26, 29]",11,4
13,10,7,"[11, 15, 19, 20, 21, 24, 26]",7,0
13,11,5,"[9, 11, 14, 19, 20, 21, 22, 26, 29]",9,4
13,12,2,"[8, 9, 11, 14, 15, 19, 20, 21, 22, 24, 27, 29]",12,10
13,13,6,"[8, 9, 11, 14, 15, 20, 22, 24, 26, 27, 29]",11,5
13,14,6,"[8, 9, 14, 15, 16, 19, 21, 22, 24, 26, 27, 28, 29]",13,7
13,15,6,"[6, 9, 11, 12, 14, 15, 16, 18, 19, 20, 21, 22, 24, 26, 27, 28]",16,10
13,16,7,"[6, 8, 11, 12, 16, 18, 19, 20, 21, 27, 28]",11,4
13,17,7,"[6, 8, 9, 11, 12, 18, 20, 22, 28]",9,2
13,18,2,"[6, 8, 9, 12, 16, 22, 27]",7,5
13,19,5,"[8, 9, 12, 16, 18, 22, 27, 28]",8,3
13,20,6,"[6, 8, 16, 18, 27, 28]",6,0
13,21,2,"[6, 12, 16, 18, 28]",5,3
13,22,2,"[6, 12, 16, 18, 28]",5,3
13,23,3,"[6, 12, 18]",3,0
14,0,7,"[1, 2, 3, 4, 7, 17, 25]",7,0
14,1,7,"[1, 2, 3, 4, 7, 17, 25]",7,0
14,2,3,"[1, 2, 3, 4, 7, 17, 25]",7,4
14,3,2,"[3, 7, 17]",3,1
14,4,3,"[1, 2, 3, 4, 25]",5,2
14,5,6,"[1, 2, 4, 7, 17, 25]",6,0
14,6,3,"[1, 2, 3, 4, 7, 13, 17, 24, 25]",9,6
14,7,7,"[1, 2, 3, 4, 7, 13, 17, 24, 25]",9,2
14,8,6,"[1, 2, 3, 4, 7, 9, 13, 17, 24, 25]",10,4
14,9,2,"[9, 13, 19, 20, 24]",5,3
14,10,5,"[9, 10, 13, 19, 20, 22, 24]",7,2
14,11,3,"[9, 10, 19, 20, 22]",5,2
14,12,7,"[9, 10, 13, 19, 20, 22, 24]",7,0
14,13,4,"[10, 13, 19, 20, 22, 24, 28]",7,3
14,14,3,"[9, 10, 12, 13, 18, 22, 24, 27, 28]",9,6
14,15,6,"[5, 6, 8, 9, 11, 12, 14, 18, 19, 20, 21, 26, 27, 28, 29]",15,9
14,16,6,"[5, 6, 8, 9, 10, 11, 12, 14, 18, 19, 20, 21, 22, 26, 27, 28, 29]",17,11
14,17,7,"[5, 6, 8, 10, 11, 12, 14, 18, 19, 20, 21, 22, 26, 27, 29]",15,8
14,18,7,"[6, 8, 10, 11, 14, 21, 22, 26, 28, 29]",10,3
14,19,5,"[5, 8, 11, 12, 14, 18, 21, 26, 27, 28, 29]",11,6
14,20,2,"[5, 6, 12, 18, 27, 28]",6,4
14,21,2,"[5, 6, 8, 11, 12, 14, 18, 21, 26, 27, 28, 29]",12,10
14,22,7,"[5, 6, 8, 11, 12, 14, 18, 21, 26, 27, 29]",11,4
14,23,7,"[5, 6, 8, 11, 14, 21, 26, 29]",8,1
15,0,7,"[0, 1, 4, 7, 15, 16, 23]",7,0
15,1,4,"[0, 1, 4, 7, 15, 16, 23]",7,3
15,2,5,"[0, 1, 4, 7, 15, 16, 23]",7,2
15,3,2,"[4, 15, 23]",3,1
15,4,7,"[0, 1, 4, 7, 15, 16, 23]",7,0
15,5,4,"[0, 1, 7, 16]",4,0
15,6,7,"[0, 1, 3, 4, 7, 9, 13, 15, 16, 20, 23, 24, 25]",13,6
15,7,4,"[0, 1, 3, 4, 7, 9, 13, 15, 16, 20, 23, 24, 25]",13,9
15,8,2,"[0, 1, 3, 4, 7, 9, 13, 15, 16, 20, 23, 24, 25]",13,11
15,9,2,"[3, 9, 20, 24]",4,2
15,10,6,"[9, 12, 13, 18, 20, 22, 24, 25]",8,2
15,11,2,"[3, 12, 13, 18, 22, 25]",6,4
15,12,4,"[3, 9, 10, 12, 13, 18, 20, 22, 24, 25]",10,6
15,13,7,"[3, 9, 10, 11, 13, 18, 20, 22, 24, 25]",10,3
15,14,2,"[3, 5, 6, 9, 10, 11, 12, 13, 20, 24, 25, 27]",12,10
15,15,3,"[2, 5, 6, 10, 11, 12, 14, 17, 18, 21, 22, 27]",12,9
15,16,4,"[2, 5, 6, 11, 12, 14, 17, 18, 21, 22, 27]",11,7
15,17,5,"[2, 5, 6, 10, 11, 12, 14, 17, 18, 21, 22, 27]",12,7
15,18,3,"[2, 5, 10, 12, 14, 17, 18, 21, 22]",9,6
15,19,2,"[6, 10, 11, 14, 17, 21, 27]",7,5
15,20,5,"[2, 5, 6, 10, 11, 27]",6,1
15,21,7,"[2, 5, 6, 11, 14, 17, 21, 27]",8,1
15,22,3,"[2, 5, 6, 14, 17, 21, 27]",7,4
15,23,4,"[2, 14, 17, 21]",4,0
16,0,7,"[0, 8, 15, 19, 23, 26, 28, 29]",8,1
16,1,4,"[0, 8, 15, 19, 23, 26, 28, 29]",8,4
16,2,5,"[0, 8, 15, 19, 23, 26, 28, 29]",8,3
16,3,5,"[15, 19, 23, 26, 28]",5,0
16,4,6,"[0, 8, 15, 19, 28, 29]",6,0
16,5,5,"[0, 8, 23, 26, 29]",5,0
16,6,7,"[0, 8, 15, 19, 23, 26, 28, 29]",8,1
16,7,4,"[0, 8, 15, 19, 23, 26, 28, 29]",8,4
16,8,2,"[0, 8, 9, 15, 19, 23, 26, 28, 29]",9,7
16,9,4,"[7, 9, 11, 25]",4,0
16,10,2,"[4, 7, 9, 11, 25]",5,3
16,11,3,"[4, 7, 9, 11, 14, 25]",6,3
16,12,4,"[4, 7, 9, 11, 12, 14, 25]",7,3
16,13,6,"[1, 2, 6, 12, 13, 14, 20, 25]",8,2
16,14,3,"[1, 2, 4, 5, 6, 7, 9, 11, 12, 13, 14, 16, 20]",13,10
16,15,5,"[1, 2, 3, 4, 5, 6, 7, 9, 11, 12, 13, 14, 16, 20, 21, 25, 27]",17,12
16,16,4,"[1, 2, 3, 4, 5, 7, 9, 11, 12, 13, 16, 20, 21, 25, 27]",15,11
16,17,5,"[1, 3, 4, 5, 6, 7, 11, 14, 20, 21, 25, 27]",12,7
16,18,4,"[2, 3, 4, 6, 12, 13, 14, 16, 21]",9,5
16,19,6,"[1, 2, 5, 6, 12, 13, 14, 16, 20, 21, 27]",11,5
16,20,5,"[1, 2, 3, 5, 6, 12, 13, 16, 20, 27]",10,5
16,21,7,"[1, 2, 3, 5, 6, 13, 16, 20, 21, 27]",10,3
16,22,4,"[3, 5, 16, 21, 27]",5,1
16,23,2,"[3, 21, 27]",3,1
17,0,7,"[8, 10, 18, 22, 23, 24, 26, 29]",8,1
17,1,4,"[8, 10, 18, 22, 23, 24, 26, 29]",8,4
17,2,6,"[8, 10, 18, 22, 23, 24, 26, 29]",8,2
17,3,5,"[8, 10, 22, 23, 29]",5,0
17,4,6,"[8, 18, 22, 24, 26, 29]",6,0
17,5,4,"[10, 18, 23, 24, 26]",5,1
17,6,3,"[8, 10, 18, 22, 23, 24, 26, 29]",8,5
17,7,2,"[8, 10, 18, 22, 23, 24, 26, 29]",8,6
17,8,5,"[4, 8, 10, 17, 18, 22, 23, 24, 26, 29]",10,5
17,9,7,"[0, 4, 6, 17, 19, 20, 28]",7,0
17,10,7,"[0, 4, 6, 17, 19, 20, 28]",7,0
17,11,5,"[0, 4, 6, 17, 19, 20, 25, 28]",8,3
17,12,5,"[0, 6, 17, 19, 20, 25]",6,1
17,13,2,"[4, 6, 13, 19, 20, 25, 27, 28]",8,6
17,14,2,"[0, 4, 13, 17, 25, 27, 28]",7,5
17,15,6,"[0, 3, 4, 5, 6, 7, 11, 13, 14, 15, 16, 17, 19, 20, 25, 27, 28]",17,11
17,16,4,"[0, 3, 4, 5, 6, 7, 11, 14, 15, 16, 17, 19, 20, 27, 28]",15,11
17,17,7,"[0, 3, 5, 6, 7, 11, 13, 14, 15, 16, 19, 20, 25, 27, 28]",15,8
17,18,7,"[3, 7, 13, 14, 15, 16, 25]",7,0
17,19,6,"[3, 5, 7, 11, 13, 25, 27]",7,1
17,20,6,"[5, 11, 13, 14, 15, 16, 27]",7,1
17,21,7,"[3, 5, 7, 11, 13, 14, 15, 16, 27]",9,2
17,22,3,"[3, 5, 7, 11, 14, 15, 16]",7,4
17,23,6,"[3, 5, 7, 11, 14, 15, 16]",7,1
18,0,3,"[8, 10, 29]",3,0
18,1,6,"[1, 2, 8, 9, 10, 29]",6,0
18,2,4,"[1, 2, 8, 9, 10, 29]",6,2
18,3,3,"[1, 2, 9]",3,0
18,4,6,"[1, 2, 8, 9, 10, 29]",6,0
18,5,4,"[8, 9, 10, 29]",4,0
18,6,6,"[1, 2, 8, 10, 17, 29]",6,0
18,7,7,"[1, 2, 8, 9, 10, 17, 25, 29]",8,1
18,8,6,"[1, 2, 8, 9, 10, 17, 20, 25, 29]",9,3
18,9,5,"[1, 2, 9, 17, 18, 20, 25]",7,2
18,10,6,"[0, 17, 18, 20, 23, 25, 27, 28]",8,2
18,11,6,"[0, 4, 18, 23, 25, 27, 28]",7,1
18,12,4,"[0, 4, 17, 20, 23, 27, 28]",7,3
18,13,7,"[0, 3, 4, 15, 17, 18, 20, 23, 25, 27, 28]",11,4
18,14,3,"[3, 4, 12, 15, 17, 18, 19, 20, 21, 22, 23, 25, 27]",13,10
18,15,6,"[0, 3, 7, 11, 12, 15, 16, 18, 19, 20, 21, 22, 24, 25, 28]",15,9
18,16,6,"[0, 3, 4, 7, 11, 12, 16, 18, 19, 20, 21, 22, 23, 24, 27, 28]",16,10
18,17,6,"[0, 4, 7, 11, 15, 16, 18, 21, 22, 23, 24, 27, 28]",13,7
18,18,5,"[0, 3, 4, 7, 11, 12, 15, 16, 19, 22, 23, 27, 28]",13,8
18,19,7,"[3, 4, 11, 12, 15, 16, 19, 21, 24]",9,2
18,20,5,"[3, 7, 12, 15, 19, 21, 22, 24]",8,3
18,21,2,"[3, 7, 11, 12, 15, 16, 19, 21, 22, 24]",10,8
18,22,4,"[7, 11, 12, 16, 19, 21, 22, 24]",8,4
18,23,2,"[7, 11, 16, 24]",4,2
19,0,5,"[6, 8, 10, 13, 29]",5,0
19,1,2,"[6, 8, 10, 13, 29]",5,3
19,2,7,"[1, 6, 8, 10, 13, 17, 29]",7,0
19,3,5,"[1, 8, 10, 13, 17]",5,0
19,4,3,"[1, 6, 8, 13, 17, 29]",6,3
19,5,4,"[1, 6, 10, 17, 29]",5,1
19,6,5,"[6, 8, 10, 13, 17, 18, 29]",7,2
19,7,5,"[1, 6, 8, 10, 13, 18, 28, 29]",8,3
19,8,3,"[1, 6, 8, 10, 13, 17, 18, 28, 29]",9,6
19,9,3,"[1, 17, 18, 28]",4,1
19,10,3,"[0, 1, 5, 17, 27, 28]",6,3
19,11,3,"[0, 4, 5, 16, 18, 24, 27, 28]",8,5
19,12,6,"[0, 3, 4, 5, 9, 15, 16, 18, 22, 24, 27]",11,5
19,13,7,"[0, 3, 4, 5, 9, 15, 16, 18, 22, 24, 27, 28]",12,5
19,14,4,"[0, 3, 4, 9, 15, 16, 18, 19, 22, 24, 27, 28]",12,8
19,15,3,"[2, 3, 4, 5, 9, 11, 12, 14, 16, 19, 20, 21, 22, 24, 25, 26, 28]",17,14
19,16,4,"[0, 2, 3, 5, 11, 12, 14, 15, 19, 20, 21, 22, 25, 26, 27]",15,11
19,17,5,"[0, 2, 4, 5, 9, 11, 12, 14, 15, 16, 19, 20, 21, 24, 25, 26, 27]",17,12
19,18,5,"[0, 3, 4, 5, 9, 12, 14, 15, 16, 19, 20, 21, 22, 24, 25, 26, 27]",17,12
19,19,7,"[2, 3, 4, 9, 11, 15, 16, 22, 24, 26]",10,3
19,20,7,"[2, 3, 9, 11, 12, 14, 15, 19, 20, 21, 22, 25]",12,5
19,21,4,"[2, 11, 12, 14, 19, 20, 21, 25, 26]",9,5
19,22,2,"[2, 11, 12, 14, 19, 20, 21, 25, 26]",9,7
19,23,6,"[2, 11, 12, 14, 20, 21, 25, 26]",8,2
20,0,6,"[1, 6, 7, 8, 17, 23, 29]",7,1
20,1,2,"[1, 6, 7, 8, 17, 23, 29]",7,5
20,2,6,"[1, 6, 7, 8, 17, 23, 29]",7,1
20,3,3,"[1, 17, 23]",3,0
20,4,5,"[6, 7, 8, 17, 29]",5,0
20,5,5,"[1, 6, 7, 8, 23, 29]",6,1
20,6,7,"[1, 6, 7, 8, 17, 23, 27, 29]",8,1
20,7,2,"[1, 6, 7, 8, 17, 23, 27, 29]",8,6
20,8,7,"[1, 5, 6, 7, 8, 9, 13, 17, 23, 27, 29]",11,4
20,9,2,"[5, 9, 13]",3,1
20,10,4,"[4, 5, 9, 13, 15, 16, 19, 27, 28]",9,5
20,11,7,"[2, 4, 5, 9, 13, 15, 16, 18, 19, 26, 27, 28]",12,5
20,12,5,"[2, 3, 4, 5, 10, 15, 16, 18, 19, 26, 27, 28]",12,7
20,13,6,"[2, 3, 4, 9, 10, 11, 13, 15, 16, 18, 19, 26, 27, 28]",14,8
20,14,4,"[3, 4, 5, 9, 10, 11, 13, 14, 15, 16, 18, 19, 26, 27, 28]",15,11
20,15,7,"[2, 3, 5, 9, 11, 13, 14, 18, 21, 22, 24, 25, 26]",13,6
20,16,4,"[2, 3, 4, 5, 9, 10, 11, 13, 14, 15, 16, 19, 21, 22, 24, 25, 28]",17,13
20,17,7,"[2, 4, 10, 11, 15, 16, 18, 19, 21, 22, 24, 25, 26, 28]",14,7
20,18,2,"[2, 3, 4, 10, 14, 15, 16, 18, 19, 21, 22, 25, 26, 28]",14,12
20,19,7,"[2, 3, 10, 11, 14, 18, 21, 24, 26]",9,2
20,20,5,"[3, 10, 11, 14, 22, 24, 25]",7,2
20,21,5,"[11, 14, 21, 22, 24, 25]",6,1
20,22,2,"[14, 21, 22, 24, 25]",5,3
20,23,3,"[21, 22, 24, 25]",4,1
21,0,6,"[0, 6, 7, 8, 17, 20]",6,0
21,1,4,"[0, 6, 7, 8, 17, 20]",6,2
21,2,4,"[0, 6, 7, 8, 17, 20, 27]",7,3
21,3,4,"[0, 6, 7, 17, 20, 27]",6,2
21,4,4,"[0, 7, 8, 27]",4,0
21,5,5,"[6, 8, 17, 20, 27]",5,0
21,6,2,"[0, 5, 6, 7, 8, 13, 17, 19, 20, 27]",10,8
21,7,4,"[0, 2, 5, 6, 7, 8, 13, 16, 17, 19, 20]",11,7
21,8,3,"[0, 2, 3, 5, 6, 7, 8, 13, 16, 17, 19, 20, 27]",13,10
21,9,7,"[1, 2, 3, 4, 5, 10, 13, 15, 16, 19, 23, 27]",12,5
21,10,6,"[1, 3, 4, 10, 15, 23, 27]",7,1
21,11,7,"[1, 2, 3, 4, 5, 10, 13, 15, 16, 19, 23, 25]",12,5
21,12,6,"[1, 2, 3, 4, 5, 10, 13, 15, 16, 19, 25]",11,5
21,13,5,"[1, 2, 4, 5, 10, 13, 15, 16, 19, 21, 23, 25]",12,7
21,14,2,"[2, 3, 5, 12, 13, 16, 19, 21, 23, 25, 28]",11,9
21,15,3,"[1, 2, 3, 4, 9, 10, 11, 12, 14, 15, 16, 18, 21, 22, 23, 24, 25, 26, 28]",19,16
21,16,5,"[1, 3, 4, 9, 10, 11, 12, 14, 15, 18, 21, 22, 23, 24, 26, 28]",16,11
21,17,4,"[1, 4, 9, 10, 11, 12, 14, 15, 18, 22, 23, 24, 25, 26]",14,10
21,18,5,"[11, 12, 14, 21, 22, 24, 25, 26, 28]",9,4
21,19,3,"[9, 11, 14, 18, 21, 22, 25, 26, 28]",9,6
21,20,4,"[9, 12, 18, 21, 24, 28]",6,2
21,21,6,"[9, 11, 12, 14, 18, 21, 22, 24, 26, 28]",10,4
21,22,7,"[9, 11, 12, 14, 18, 22, 24, 26, 28]",9,2
21,23,7,"[9, 11, 14, 18, 22, 24, 26]",7,0
22,0,6,"[0, 6, 7, 8, 17, 20, 29]",7,1
22,1,2,"[0, 6, 7, 8, 17, 20, 29]",7,5
22,2,3,"[0, 6, 7, 8, 17, 20, 29]",7,4
22,3,7,"[0, 6, 7, 8, 17, 20, 29]",7,0
22,4,3,"[7, 20, 29]",3,0
22,5,4,"[0, 6, 8, 17]",4,0
22,6,3,"[0, 1, 4, 6, 7, 8, 17, 20, 23, 29]",10,7
22,7,7,"[0, 1, 4, 6, 7, 8, 17, 20, 23, 25, 29]",11,4
22,8,7,"[0, 1, 4, 6, 7, 8, 17, 19, 20, 23, 25, 29]",12,5
22,9,5,"[1, 3, 19, 21, 25]",5,0
22,10,4,"[2, 3, 4, 12, 19, 21, 23]",7,3
22,11,4,"[1, 2, 3, 4, 5, 12, 16, 19, 21, 23, 24, 25]",12,8
22,12,6,"[1, 2, 3, 4, 5, 12, 16, 19, 21, 23, 24, 25]",12,6
22,13,3,"[1, 2, 3, 4, 5, 16, 21, 23, 24, 25]",10,7
22,14,5,"[1, 2, 4, 5, 12, 19, 23, 24, 25]",9,4
22,15,2,"[3, 9, 11, 12, 13, 14, 16, 18, 19, 21, 22, 24, 25, 26, 27, 28]",16,14
22,16,7,"[2, 3, 5, 9, 11, 12, 13, 14, 16, 18, 19, 21, 22, 26, 27, 28]",16,9
22,17,2,"[2, 3, 5, 9, 11, 12, 13, 14, 16, 18, 21, 22, 24, 26, 27, 28]",16,14
22,18,5,"[2, 5, 11, 12, 13, 16, 18, 22, 24, 27, 28]",11,6
22,19,7,"[5, 9, 11, 14, 16, 18, 22, 24, 26]",9,2
22,20,4,"[9, 13, 14, 26, 27, 28]",6,2
22,21,3,"[9, 11, 13, 14, 18, 22, 26, 27, 28]",9,6
22,22,3,"[9, 11, 13, 14, 18, 22, 26, 27, 28]",9,6
22,23,7,"[9, 11, 13, 14, 18, 22, 26, 27, 28]",9,2
23,0,2,"[0, 10, 29]",3,1
23,1,5,"[0, 7, 10, 15, 29]",5,0
23,2,7,"[0, 1, 6, 7, 10, 15, 29]",7,0
23,3,2,"[0, 1, 6, 7, 10, 15, 29]",7,5
23,4,3,"[1, 6, 7, 15]",4,1
23,5,5,"[0, 1, 6, 10, 15, 29]",6,1
23,6,2,"[0, 1, 7, 10, 12, 20, 29]",7,5
23,7,7,"[0, 6, 7, 10, 12, 15, 16, 20, 29]",9,2
23,8,2,"[0, 1, 6, 7, 10, 12, 15, 16, 20, 29]",10,8
23,9,7,"[1, 2, 6, 7, 12, 15, 16, 20]",8,1
23,10,3,"[1, 2, 3, 6, 19]",5,2
23,11,7,"[2, 3, 12, 16, 19, 20, 22, 25, 26]",9,2
23,12,7,"[2, 3, 12, 16, 19, 20, 22, 25, 26]",9,2
23,13,5,"[2, 3, 12, 16, 20, 22, 25, 26]",8,3
23,14,6,"[12, 16, 19, 20, 22, 26, 28]",7,1
23,15,7,"[2, 3, 4, 5, 9, 11, 13, 14, 16, 17, 18, 19, 21, 25, 26, 27, 28]",17,10
23,16,7,"[2, 3, 4, 5, 9, 11, 13, 14, 17, 18, 19, 21, 22, 25, 27, 28]",16,9
23,17,6,"[2, 3, 4, 5, 9, 11, 13, 14, 17, 18, 19, 21, 22, 25, 26, 27]",16,10
23,18,6,"[3, 9, 13, 14, 18, 19, 21, 22, 25, 26, 27, 28]",12,6
23,19,2,"[4, 5, 9, 11, 17, 21, 22, 25, 26, 27, 28]",11,9
23,20,3,"[4, 5, 11, 13, 14, 17, 18, 28]",8,5
23,21,4,"[4, 5, 9, 11, 13, 14, 17, 18, 21, 27, 28]",11,7
23,22,7,"[4, 5, 9, 11, 13, 14, 17, 18, 21, 27, 28]",11,4
23,23,7,"[4, 5, 9, 11, 13, 14, 17, 18, 21, 27]",10,3
24,0,7,"[0, 1, 6, 8, 15, 23, 24]",7,0
24,1,6,"[0, 1, 6, 8, 15, 23, 24]",7,1
24,2,7,"[0, 1, 6, 8, 15, 23, 24]",7,0
24,3,4,"[0, 1, 15, 24]",4,0
24,4,6,"[0, 6, 8, 15, 23, 24]",6,0
24,5,3,"[1, 6, 8, 23]",4,1
24,6,7,"[0, 1, 2, 6, 8, 15, 23, 24]",8,1
24,7,7,"[0, 1, 2, 6, 8, 15, 20, 23, 24]",9,2
24,8,3,"[0, 1, 2, 6, 8, 15, 20, 22, 23, 24, 25]",11,8
24,9,3,"[2, 20, 22, 25, 26, 29]",6,3
24,10,2,"[20, 22, 25, 26, 29]",5,3
24,11,5,"[2, 7, 10, 13, 14, 20, 22, 25, 26, 29]",10,5
24,12,7,"[2, 7, 9, 10, 13, 14, 22, 25, 26, 29]",10,3
24,13,2,"[2, 7, 9, 10, 13, 14, 20, 26, 29]",9,7
24,14,5,"[2, 7, 9, 10, 13, 14, 20, 22, 25]",9,4
24,15,6,"[3, 4, 5, 7, 9, 10, 11, 12, 13, 14, 16, 18, 19, 20, 21, 22, 25, 26, 28, 29]",20,14
24,16,7,"[3, 4, 5, 11, 12, 16, 18, 19, 21, 22, 25, 26, 28, 29]",14,7
24,17,2,"[3, 4, 5, 7, 9, 10, 11, 12, 13, 14, 16, 18, 19, 21, 26, 28, 29]",17,15
24,18,4,"[3, 4, 5, 7, 9, 10, 11, 12, 13, 14, 18, 19, 21]",13,9
24,19,6,"[3, 5, 7, 9, 10, 11, 12, 13, 14, 16, 18, 21, 28]",13,7
24,20,5,"[4, 9, 16, 19, 28]",5,0
24,21,3,"[3, 4, 5, 11, 12, 16, 18, 19, 21, 28]",10,7
24,22,2,"[3, 4, 5, 11, 12, 16, 18, 19, 21, 28]",10,8
24,23,6,"[3, 4, 5, 11, 12, 16, 18, 19, 21, 28]",10,4
25,0,5,"[1, 6, 8, 15, 23, 24, 27]",7,2
25,1,7,"[1, 6, 8, 15, 23, 24, 27]",7,0
25,2,7,"[1, 6, 8, 15, 23, 24, 27]",7,0
25,3,3,"[6, 8, 23]",3,0
25,4,4,"[1, 15, 24, 27]",4,0
25,5,7,"[1, 6, 8, 15, 23, 24, 27]",7,0
25,6,5,"[0, 1, 6, 8, 15, 23, 24, 27]",8,3
25,7,2,"[0, 1, 6, 8, 15, 23, 24, 26, 27, 29]",10,8
25,8,3,"[0, 1, 6, 7, 8, 14, 15, 20, 22, 23, 24, 25, 26, 27, 29]",15,12
25,9,6,"[0, 7, 10, 13, 14, 20, 22, 25, 26, 29]",10,4
25,10,7,"[0, 7, 10, 13, 14, 17, 20, 22, 25, 26, 29]",11,4
25,11,7,"[7, 10, 13, 17, 20, 25, 26]",7,0
25,12,5,"[0, 3, 7, 10, 13, 14, 17, 20, 22, 29]",10,5
25,13,3,"[0, 3, 13, 14, 17, 22, 25, 26, 29]",9,6
25,14,7,"[0, 3, 7, 10, 14, 16, 20, 22, 25, 26, 29]",11,4
25,15,6,"[3, 4, 5, 7, 9, 10, 11, 12, 13, 14, 16, 17, 19, 20, 21, 22, 25, 26, 29]",19,13
25,16,6,"[3, 4, 5, 7, 9, 10, 11, 12, 13, 14, 16, 17, 19, 20, 21, 22, 25]",17,11
25,17,7,"[4, 5, 9, 10, 11, 12, 13, 16, 17, 19, 21]",11,4
25,18,6,"[3, 4, 5, 9, 11, 12, 17]",7,1
25,19,2,"[3, 4, 12, 16, 19, 21]",6,4
25,20,6,"[3, 5, 9, 11, 16, 19, 21]",7,1
25,21,6,"[4, 5, 9, 11, 12, 16, 19, 21]",8,2
25,22,5,"[4, 5, 9, 11, 12, 16, 19, 21]",8,3
25,23,4,"[4, 5, 9, 11, 12, 19, 21]",7,3
26,0,6,"[1, 2, 8, 15, 18, 23, 24, 28]",8,2
26,1,5,"[1, 2, 8, 15, 18, 23, 24, 28]",8,3
26,2,3,"[1, 2, 8, 15, 18, 23, 24, 28]",8,5
26,3,4,"[2, 15, 18, 28]",4,0
26,4,6,"[1, 2, 8, 15, 23, 24]",6,0
26,5,6,"[1, 8, 18, 23, 24, 28]",6,0
26,6,2,"[1, 2, 6, 8, 15, 18, 22, 23, 24, 28]",10,8
26,7,4,"[1, 2, 6, 8, 15, 17, 18, 22, 23, 24, 28]",11,7
26,8,4,"[1, 2, 3, 6, 8, 10, 14, 15, 17, 18, 20, 22, 23, 24, 28]",15,11
26,9,7,"[3, 6, 7, 10, 14, 17, 20, 22]",8,1
26,10,3,"[3, 6, 7, 10, 14, 17, 20, 22]",8,5
26,11,4,"[3, 4, 7, 10, 14, 17, 20, 26]",8,4
26,12,4,"[4, 6, 7, 20, 21, 22, 26]",7,3
26,13,5,"[3, 4, 6, 10, 14, 17, 21, 22, 26]",9,4
26,14,7,"[3, 4, 6, 7, 9, 10, 14, 16, 17, 20, 21, 22, 26, 29]",14,7
26,15,2,"[0, 3, 5, 7, 9, 10, 11, 12, 13, 14, 16, 17, 19, 20, 21, 25, 26, 29]",18,16
26,16,3,"[0, 3, 4, 5, 7, 9, 10, 11, 12, 13, 14, 16, 19, 20, 25, 29]",16,13
26,17,4,"[0, 4, 5, 7, 11, 12, 13, 16, 19, 21, 25, 26]",12,8
26,18,2,"[0, 4, 5, 9, 11, 12, 13, 21, 25, 26, 29]",11,9
26,19,2,"[0, 4, 9, 11, 12, 16, 19, 21, 25, 26, 29]",11,9
26,20,5,"[5, 9, 13, 16, 19, 21, 29]",7,2
26,21,2,"[0, 5, 9, 11, 12, 13, 16, 19, 25, 29]",10,8
26,22,5,"[0, 5, 9, 11, 12, 13, 16, 19, 25, 29]",10,5
26,23,3,"[0, 5, 11, 12, 13, 19, 25]",7,4
27,0,2,"[15, 23]",2,0
27,1,5,"[8, 15, 18, 23, 28]",5,0
27,2,6,"[6, 8, 15, 18, 23, 28]",6,0
27,3,4,"[6, 8, 15, 18, 23, 28]",6,2
27,4,2,"[6, 8, 18]",3,1
27,5,3,"[15, 23, 28]",3,0
27,6,3,"[6, 8, 15, 18, 23, 28]",6,3
27,7,7,"[6, 8, 15, 18, 20, 23, 27, 28]",8,1
27,8,4,"[6, 8, 15, 18, 20, 23, 27, 28]",8,4
27,9,6,"[6, 7, 8, 18, 20, 22, 26, 27, 28]",9,3
27,10,4,"[2, 6, 7, 20, 22, 26, 27, 29]",8,4
27,11,2,"[2, 7, 22, 26, 29]",5,3
27,12,7,"[2, 7, 13, 16, 20, 22, 27, 29]",8,1
27,13,2,"[7, 13, 16, 20, 22, 24, 26, 27, 29]",9,7
27,14,4,"[0, 1, 2, 3, 4, 5, 12, 13, 16, 19, 20, 24, 25, 26, 27]",15,11
27,15,7,"[0, 1, 2, 3, 4, 5, 7, 10, 12, 13, 16, 17, 19, 20, 21, 22, 24, 25, 26, 27, 29]",21,14
27,16,3,"[0, 1, 2, 3, 4, 5, 7, 10, 12, 16, 17, 19, 21, 22, 24, 25, 26, 29]",18,15
27,17,7,"[0, 1, 2, 4, 7, 10, 12, 13, 17, 19, 21, 22, 24, 25, 26, 29]",16,9
27,18,4,"[0, 1, 2, 3, 4, 5, 10, 13, 16, 17, 19, 21, 29]",13,9
27,19,3,"[3, 5, 12, 13, 16, 21, 24, 25]",8,5
27,20,2,"[0, 1, 3, 4, 5, 10, 12, 13, 16, 17, 19, 24, 25]",13,11
27,21,3,"[0, 1, 3, 4, 5, 10, 12, 17, 19, 21, 24, 25]",12,9
27,22,6,"[0, 1, 3, 4, 5, 10, 12, 17, 19, 21, 25]",11,5
27,23,2,"[10, 17, 21]",3,1
28,0,3,"[8, 18, 23, 28]",4,1
28,1,4,"[8, 18, 23, 28]",4,0
28,2,5,"[8, 9, 15, 18, 23, 28]",6,1
28,3,4,"[8, 9, 15, 18, 28]",5,1
28,4,6,"[8, 9, 15, 18, 23, 28]",6,0
28,5,3,"[9, 15, 23]",3,0
28,6,2,"[8, 9, 18, 23, 28]",5,3
28,7,6,"[2, 8, 15, 18, 22, 23, 28]",7,1
28,8,4,"[2, 6, 8, 9, 15, 18, 22, 23, 26, 27, 28]",11,7
28,9,4,"[2, 6, 9, 15, 22, 26, 27]",7,3
28,10,4,"[2, 6, 9, 15, 26, 27]",6,2
28,11,5,"[1, 2, 22, 24, 26, 27, 29]",7,2
28,12,2,"[0, 1, 6, 22, 24, 26, 29]",7,5
28,13,4,"[0, 1, 2, 6, 10, 13, 16, 22, 24, 27, 29]",11,7
28,14,6,"[0, 1, 2, 6, 10, 12, 13, 16, 22, 24, 26, 27]",12,6
28,15,3,"[0, 2, 6, 7, 10, 12, 13, 14, 16, 17, 19, 21, 22, 24, 26, 27, 29]",17,14
28,16,4,"[1, 6, 7, 10, 12, 13, 14, 17, 19, 21, 26, 27, 29]",13,9
28,17,7,"[0, 1, 7, 12, 13, 14, 16, 17, 19, 21, 24, 29]",12,5
28,18,7,"[0, 1, 10, 12, 14, 16, 21, 24, 29]",9,2
28,19,7,"[0, 1, 7, 10, 13, 16, 17, 19, 21, 24, 29]",11,4
28,20,3,"[0, 7, 10, 12, 13, 14, 16, 17, 19]",9,6
28,21,4,"[7, 10, 12, 13, 14, 16, 17, 19, 21]",9,5
28,22,5,"[7, 12, 14, 15, 17, 19, 21]",7,2
28,23,5,"[7, 9, 14, 15, 17, 18, 19, 21]",8,3
29,0,7,"[9, 11, 15, 18, 20, 25, 28]",7,0
29,1,2,"[9, 11, 15, 18, 20, 25, 28]",7,5
29,2,2,"[11, 15, 20, 25, 28]",5,3
29,3,3,"[9, 11, 18, 20, 25, 28]",6,3
29,4,7,"[9, 11, 15, 18, 20, 25, 28]",7,0
29,5,3,"[9, 15, 18]",3,0
29,6,6,"[2, 8, 9, 11, 15, 18, 20, 22, 25, 28]",10,4
29,7,5,"[2, 8, 9, 11, 18, 20, 22, 25, 27, 28]",10,5
29,8,2,"[2, 4, 8, 11, 20, 22, 25, 27, 28]",9,7
29,9,7,"[2, 4, 8, 13, 22, 23, 27]",7,0
29,10,2,"[4, 13, 23]",3,1
29,11,7,"[2, 4, 8, 13, 22, 23, 27]",7,0
29,12,6,"[2, 4, 8, 13, 22, 23, 27]",7,1
29,13,2,"[2, 8, 13, 22, 23, 27]",6,4
29,14,2,"[2, 4, 8, 22, 27]",5,3
29,15,2,"[3, 4, 7, 12, 13, 14, 19, 23, 24, 27, 29]",11,9
29,16,3,"[3, 4, 7, 12, 13, 14, 19, 23, 24, 29]",10,7
29,17,5,"[3, 7, 12, 13, 14, 19, 23, 24, 29]",9,4
29,18,5,"[3, 7, 14, 19, 24, 29]",6,1
29,19,2,"[12, 24]",2,0
29,20,6,"[3, 7, 12, 14, 19, 29]",6,0
29,21,5,"[3, 7, 12, 14, 19, 24, 29]",7,2
29,22,5,"[3, 7, 12, 14, 19, 24, 29]",7,2
29,23,7,"[3, 7, 12, 14, 19, 24, 29]",7,0
